9.ox
.........
.........
.oo......
o........
.o.......
........o
....oo..o
.........
.........
